24
27
15
1CCCCCCCCCCCCCCCICCCCCCCC2I
L...............I........RI
L...............I........RI
L...............I........RI
L.FFFFFF........IFFFF....RI
L......I........CCCCC....RI
L......I...FFF...........RI
L......I...III...........RI
L......I...III...........RI
L......I...III..FFF......RI
L..........III..III......RI
L..........III..III......RI
L..........III..III.....FRI
L..........III..III.....IRI
3FFFFFFFFFFIIIFFIIIFFFFFI4I