24
27
15
1CCCCCCCCCCCCCCCCCCCCCCCC2I
L........................RI
L........................RI
L........................RI
L........................RI
L........................RI
L........................RI
IFFFFFFFFFFFFFFF.........RI
L...................FF...RI
L........................RI
L........................RI
L........................RI
L..........FFFFF....FFFFF4I
L.....FFFFFIIIII....IIIIIII
3FFFFFIIIIIIIIIIFFFFIIIIIII