24
27
15
1CCCCCCCCCCCCCCCCCCCCCCCC2I
L........................RI
L........................RI
L........................RI
L........................RI
IFFFFFFFFFFFFFFF......F..RI
L..............I......I..RI
L..............I......I..RI
L..............I......I..RI
L..............I......I..RI
L..............I..F...I..RI
L..............IFFIFFFI..RI
L........................RI
3FFFF....................RI
IIIIIFFFFFFFFFFFFFFFFFFFF4I