24
27
15
1CCCCCCCCCCCCCCCCCCCCCCCC2I
L........................RI
L........................RI
L........................RI
L........................RI
L........................RI
L........................RI
L........................RI
L........................RI
L........................RI
L........................RI
L........................RI
L........................RI
L........................RI
3FFFFFFFFFFFFFFFFFFFFFFFF4I