24
27
15
ICCCCCCCCCCCCCCCCCCCCCCCCI
L........................R
L........................R
L........................R
L........................R
L........................R
L........................R
L........................R
L........................R
L........................R
L........................R
L..............FFF.......R
L...........FF...........R
L.....FFFFF..............R
IFFFFFFFFFFFFFFFFFFFFFFFFI