24
27
15
1CCCCCCCCCCCCCCCCCCCCCCCC2I
L........................RI
L........................RI
L........................RI
L........................RI
L........................RI
L........................RI
L........................RI
L.......FFFFF...F........RI
L...............I........RI
L...............I........RI
L...............I..FFFFF.RI
L...........FFFFI........RI
L.....FFFF..IIIII........RI
3FFFFFIIIIFFIIIIIFFFFFFFF4I