24
27
15
1CCCCCCCCCCCCCCCCCCCCCCCC2I
L........................RI
L........................RI
L........................RI
L........................RI
L........................RI
L........................RI
L........................RI
L........................RI
L........................RI
L........................RI
L...................FFFF.RI
L...........FFFF.........RI
L.....FFFF...............RI
3FFFFFIIIIFFFFFFFFFFFFFFF4I